# Source: https://github.com/tyrchen/fast2s/blob/0940d611d6cbf4fd79f096f8b681ef271e1c4573/src/t2s.txt
撃	击
蘄	蕲
誇	夸
氈	毡
輊	轾
甎	砖
預	预
龕	龛
辮	辫
瀠	潆
璣	玑
錢	钱
媧	娲
礦	矿
鶩	鹜
鰨	鳎
齜	龇
綉	绣
貳	贰
踴	踊
銷	销
鄶	郐
閹	阉
鐸	铎
墻	墙
漊	溇
談	谈
襆	幞
豈	岂
駑	驽
織	织
腖	胨
軟	软
遠	远
鶺	鹡
癤	疖
緩	缓
鱨	鲿
齪	龊
飩	饨
歲	岁
鐿	镱
鯽	鲫
黿	鼋
瀋	渖
劌	刿
鋙	铻
閎	闳
餑	饽
鰓	鳃
鮒	鲋
纔	才
攙	搀
頲	颋
謝	谢
檜	桧
丟	丢
無	无
鎢	钨
眥	眦
鵰	雕
氳	氲
殲	歼
漵	溆
鈷	钴
囈	呓
頻	频
媼	媪
綾	绫
曄	晔
賈	贾
運	运
鍍	镀
鋌	铤
嗎	吗
饑	饥
磐	盘
鯒	鲬
衛	卫
諜	谍
蹟	迹
鑣	镳
叢	丛
盤	盘
姦	奸
虯	虬
併	并
剷	铲
斃	毙
賢	贤
蠆	虿
贈	赠
鯖	鲭
銍	铚
鞏	巩
齙	龅
經	经
弔	吊
蘚	藓
剛	刚
馱	驮
閣	阁
鷚	鹨
嚥	咽
頦	颏
鴨	鸭
憫	悯
梱	捆
唸	念
瘺	瘘
媽	妈
鰾	鳔
衆	众
瘍	疡
釋	释
湊	凑
湣	愍
磑	硙
祐	佑
鷓	鹧
廕	荫
聖	圣
敘	叙
櫝	椟
譜	谱
濟	济
鉢	钵
寧	宁
鳩	鸠
絨	绒
繪	绘
蟯	蛲
該	该
鏷	镤
橫	横
釁	衅
螄	蛳
躊	踌
爍	烁
頑	顽
紓	纾
鸕	鸬
龔	龚
薘	荙
訝	讶
讜	谠
輟	辍
貞	贞
産	产
犢	犊
鬧	闹
鰩	鳐
鸝	鹂
脫	脱
麪	面
蠱	蛊
課	课
皺	皱
擴	扩
彊	强
蟄	蛰
車	车
鉍	铋
鏌	镆
駐	驻
鵓	鹁
髒	脏
繕	缮
滸	浒
鈥	钬
壯	壮
轟	轰
賞	赏
啣	衔
勢	势
噥	哝
筧	笕
籩	笾
編	编
慫	怂
蓮	莲
迴	回
獷	犷
彿	佛
糾	纠
戀	恋
贊	赞
眎	视
鮑	鲍
騐	验
纓	缨
餒	馁
錯	错
輞	辋
隣	邻
閥	阀
義	义
耬	耧
朮	术
褲	裤
傷	伤
錶	表
嘸	呒
絞	绞
鮋	鲉
凍	冻
瓏	珑
饒	饶
鱔	鳝
櫛	栉
觝	抵
鏡	镜
銑	铣
監	监
煢	茕
闥	闼
瑤	瑶
磧	碛
筦	管
鵪	鹌
擯	摈
詰	诘
襲	袭
淵	渊
鍶	锶
噸	吨
嫻	娴
塼	砖
蔔	卜
憂	忧
載	载
溈	沩
鴕	鸵
莖	茎
暘	旸
訛	讹
錡	锜
銠	铑
誰	谁
覲	觐
貴	贵
隸	隶
餽	馈
碼	码
擄	掳
毆	殴
轉	转
鉋	刨
駒	驹
絕	绝
詛	诅
補	补
陣	阵
顧	顾
實	实
黨	党
艫	舻
葯	药
賴	赖
遷	迁
痺	痹
飼	饲
篔	筼
攄	摅
躉	趸
氊	毡
閏	闰
頒	颁
純	纯
舖	铺
條	条
錠	锭
麩	麸
鴉	鸦
進	进
譟	噪
琺	珐
個	个
鶿	鹚
績	绩
詆	诋
佈	布
兌	兑
顒	颙
輸	输
裝	装
湞	浈
鍠	锽
婦	妇
廩	廪
諱	讳
議	议
釷	钍
鉶	铏
飽	饱
繾	缱
會	会
複	复
誆	诓
階	阶
鮐	鲐
嶔	嵚
螘	蚁
講	讲
撚	捻
亞	亚
厠	厕
傢	家
閤	合
餧	喂
羨	羡
許	许
輳	辏
滲	渗
儷	俪
頽	颓
鴿	鸽
揀	拣
鑊	镬
鍋	锅
賊	贼
問	问
巔	巅
歛	敛
據	据
衝	冲
鑥	镥
奧	奥
繩	绳
繽	缤
捫	扪
覦	觎
話	话
棲	栖
鋶	锍
噹	当
權	权
銃	铳
綑	捆
鰐	鳄
弒	弑
巗	岩
阯	址
攖	撄
檟	槚
閡	阂
鐠	镨
鴦	鸯
撫	抚
嬪	嫔
漲	涨
訴	诉
隷	隶
餾	馏
懾	慑
鋏	铗
緑	绿
籐	藤
壓	压
齒	齿
鯕	鲯
櫟	栎
闡	阐
鑠	铄
鉤	钩
給	给
硨	砗
詢	询
慮	虑
當	当
釹	钕
偸	偷
鍺	锗
翽	翙
鹼	碱
鑪	炉
變	变
圍	围
嬭	奶
崑	昆
頓	顿
鷯	鹩
蘗	檗
輝	辉
訟	讼
勱	劢
倣	仿
縧	绦
鍰	锾
風	风
鮪	鲔
戯	戏
憮	怃
貰	贳
農	农
閶	阊
鰻	鳗
缽	钵
麼	么
蕁	荨
蓀	荪
瑋	玮
鵑	鹃
顓	颛
習	习
體	体
揚	扬
機	机
灣	湾
決	决
鍥	锲
鋤	锄
緦	缌
奩	奁
鯪	鲮
曬	晒
嗶	哔
廼	乃
軻	轲
澇	涝
疋	匹
訊	讯
崐	昆
搖	摇
溝	沟
輜	辎
璡	琎
銥	铱
碩	硕
館	馆
吶	呐
儸	罗
綻	绽
爺	爷
麽	么
頴	颕
擁	拥
時	时
闋	阕
瑣	琐
過	过
鵐	鹀
繒	缯
髕	髌
慘	惨
仝	同
衞	卫
員	员
釣	钓
癢	痒
鋥	锃
鍤	锸
壩	坝
綽	绰
驪	骊
華	华
槳	桨
譴	谴
執	执
價	价
緻	致
鉺	铒
黽	黾
鯿	鳊
薀	蕰
掄	抡
覈	核
嘍	喽
簑	蓑
餓	饿
贛	赣
袞	衮
鐡	铁
別	别
厤	历
窪	洼
蘭	兰
鯉	鲤
褳	裢
鴻	鸿
總	总
墾	垦
佇	伫
韌	韧
驕	骄
鯔	鲻
臘	腊
歟	欤
痠	酸
離	离
鏤	镂
齧	啮
竪	竖
蟬	蝉
軲	轱
詵	诜
鹽	盐
孿	孪
飾	饰
炁	气
計	计
邏	逻
徑	径
縐	绉
鴒	鸰
禕	祎
掙	挣
舘	馆
梟	枭
銣	铷
產	产
粧	妆
厰	厂
暫	暂
礪	砺
萬	万
屜	屉
澱	淀
檳	槟
鈸	钹
儺	傩
嶽	岳
鰼	鳛
嬾	懒
資	资
轆	辘
毉	医
橈	桡
雋	隽
楊	杨
闍	阇
鑌	镔
烏	乌
獎	奖
鵒	鹆
駕	驾
顔	颜
軛	轭
慚	惭
棟	栋
埡	垭
噠	哒
勣	绩
啢	唡
灤	滦
鳧	凫
齦	龈
篩	筛
穨	颓
奪	夺
鶓	鹋
濱	滨
審	审
櫳	栊
鏹	镪
鉸	铰
廻	回
驁	骜
斂	敛
脅	胁
澆	浇
瘋	疯
瀏	浏
餕	馂
搗	捣
減	减
憚	惮
蠟	蜡
殞	殒
眡	视
鈣	钙
関	关
炤	照
鬩	阋
歷	历
禪	禅
蔭	荫
諳	谙
絲	丝
堿	碱
旂	旗
證	证
廐	厩
巒	峦
祕	秘
臚	胪
賜	赐
闢	辟
煥	焕
鱧	鳢
姪	侄
蕭	萧
擬	拟
聯	联
揮	挥
詳	详
極	极
鑷	镊
卹	恤
勸	劝
釺	钎
掃	扫
肅	肃
祗	只
涇	泾
檉	柽
峴	岘
甌	瓯
鈎	钩
缐	线
鮓	鲊
鰒	鳆
貝	贝
樞	枢
鎣	蓥
嶧	峄
窩	窝
鬨	哄
來	来
攬	揽
燜	焖
銹	锈
錸	铼
盞	盏
禿	秃
騾	骡
慄	栗
諉	诿
韋	韦
衊	蔑
剎	刹
鱒	鳟
濛	蒙
泝	溯
詞	词
盡	尽
僥	侥
髩	鬓
魨	鲀
勦	剿
樓	楼
臯	皋
潰	溃
紕	纰
襴	襕
狹	狭
獸	兽
遺	遗
峽	峡
駿	骏
贇	赟
國	国
縑	缣
龐	庞
幃	帏
輛	辆
鸛	鹳
語	语
瘡	疮
膚	肤
醤	酱
鴝	鸲
斬	斩
謳	讴
貲	资
嚶	嘤
鈹	铍
鎸	镌
為	为
簽	签
鶼	鹣
餿	馊
闌	阑
繹	绎
駔	驵
敗	败
曖	暧
艙	舱
潛	潜
卻	却
櫞	橼
癡	痴
釤	钐
奐	奂
穩	稳
鯨	鲸
飪	饪
濰	潍
觴	觞
長	长
祿	禄
佔	占
謂	谓
鮍	鲏
纏	缠
錒	锕
嘔	呕
蕘	荛
趙	赵
漚	沤
蔞	蒌
鬢	鬓
羥	羟
犧	牺
閩	闽
鐨	镄
攆	撵
殭	僵
撳	揿
茲	兹
綹	绺
賃	赁
壋	垱
驌	骕
黏	粘
絎	绗
諗	谂
襖	袄
礎	础
駡	骂
魢	鱾
鯧	鲳
鳶	鸢
嗩	唢
詬	诟
滯	滞
聰	聪
捲	卷
柵	栅
巹	卺
鱸	鲈
鏽	锈
輅	辂
與	与
撈	捞
鬍	胡
鸏	鹲
鐓	镦
託	托
視	视
餡	馅
鰣	鲥
鈧	钪
説	说
騷	骚
紹	绍
銼	锉
閾	阈
轅	辕
滄	沧
塋	茔
筍	笋
詗	诇
號	号
壠	垄
鱣	鳣
寢	寝
彥	彦
燦	灿
櫬	榇
湯	汤
摳	抠
緒	绪
絹	绢
翺	翱
鋼	钢
樂	乐
蘊	蕴
嬌	娇
導	导
傑	杰
儐	傧
間	间
鈒	钑
隕	陨
窯	窑
夠	够
綣	绻
麥	麦
鎧	铠
瀦	潴
鵝	鹅
阪	坂
謬	谬
辯	辩
戲	戏
錼	镎
鈴	铃
滅	灭
轄	辖
恆	恒
鈍	钝
孌	娈
僑	侨
闓	闿
賙	赒
緹	缇
緣	缘
穢	秽
諭	谕
惱	恼
杴	锨
鯷	鳀
燻	熏
狽	狈
鍼	针
響	响
鑾	銮
薈	荟
們	们
劒	剑
謗	谤
愛	爱
蒞	莅
頡	颉
鴣	鸪
帥	帅
閨	闺
險	险
設	设
輯	辑
臉	脸
緲	缈
颶	飓
簹	筜
綸	纶
儻	傥
鈽	钸
觀	观
諂	谄
葉	叶
饋	馈
驍	骁
攣	挛
齏	齑
灑	洒
燐	磷
啓	启
鋒	锋
棖	枨
汙	污
嶴	岙
蝟	猬
懺	忏
瑩	莹
囪	囱
詭	诡
毬	球
潯	浔
魷	鱿
鷸	鹬
牽	牵
禍	祸
頌	颂
爐	炉
鄒	邹
鐔	镡
欖	榄
悅	悦
撟	挢
夢	梦
鶥	鹛
鶇	鸫
錦	锦
阨	厄
貯	贮
戰	战
徹	彻
銻	锑
紺	绀
璿	璇
眾	众
堊	垩
籠	笼
嫋	袅
姍	姗
題	题
齎	赍
鏑	镝
牐	闸
煒	炜
闕	阙
鑔	镲
棗	枣
譖	谮
鯡	鲱
穠	秾
廣	广
饢	馕
鷥	鸶
鱤	鳡
諫	谏
輿	舆
翹	翘
勻	匀
遼	辽
謁	谒
鯀	鲧
贅	赘
暈	晕
薊	蓟
鰏	鲾
瘓	痪
熒	荧
甕	瓮
讖	谶
螞	蚂
嬡	嫒
縣	县
紥	扎
瀧	泷
鎦	镏
嚨	咙
喪	丧
澮	浍
憲	宪
頷	颔
鮶	鲪
嶺	岭
琿	珲
牴	抵
譁	哗
賄	贿
籤	签
噓	嘘
燒	烧
瓔	璎
淚	泪
摟	搂
幣	币
駢	骈
詫	诧
並	并
業	业
懲	惩
敵	敌
蓴	莼
寶	宝
鉻	铬
鷺	鹭
鑿	凿
檁	檩
謀	谋
贄	贽
暉	晖
箋	笺
萊	莱
餌	饵
綏	绥
劑	剂
錐	锥
訖	讫
亙	亘
掛	挂
愜	惬
薟	莶
蘞	蔹
蘇	苏
鈦	钛
殫	殚
儉	俭
蔴	麻
騶	驺
麹	曲
鰺	鲹
儼	俨
閿	阌
濃	浓
賅	赅
懇	恳
曉	晓
篋	箧
饌	馔
韓	韩
滙	汇
癥	症
換	换
汚	污
塢	坞
鳥	鸟
釧	钏
鉦	钲
靨	靥
瑪	玛
襬	摆
聲	声
鱺	鲡
腫	肿
樁	桩
讀	读
較	较
脇	胁
嬋	婵
鏃	镞
鈑	钣
圓	圆
閔	闵
渙	涣
罎	坛
鰥	鳏
鶤	鹍
鄧	邓
銦	铟
嘩	哗
謫	谪
覬	觊
結	结
溮	浉
萵	莴
鶲	鹟
窶	窭
縹	缥
猻	狲
詁	诂
毀	毁
晉	晋
蟈	蝈
擊	击
額	额
廎	庼
鉑	铂
鏐	镠
鑕	锧
闔	阖
論	论
濘	泞
賚	赉
穡	穑
篠	筱
齣	出
壢	坜
籥	钥
內	内
鋦	锔
癩	癞
譫	谵
艱	艰
惲	恽
藴	蕴
競	竞
幹	干
獻	献
災	灾
燼	烬
蔆	菱
龍	龙
鸌	鹱
餎	饹
閑	闲
鐐	镣
園	园
鈔	钞
贖	赎
謾	谩
謚	谥
鶡	鹖
騤	骙
甦	苏
瀨	濑
貫	贯
辭	辞
測	测
檯	台
頸	颈
鞽	鞒
轂	毂
曇	昙
應	应
鐳	镭
荊	荆
髏	髅
譚	谭
虜	虏
緡	缗
鱠	鲙
驤	骧
盧	卢
釩	钒
獪	狯
黷	黩
絶	绝
矽	硅
發	发
澂	澄
誄	诔
昇	升
尋	寻
莊	庄
續	续
騏	骐
禎	祯
錕	锟
涖	莅
梘	枧
讚	赞
紡	纺
鬥	斗
瘧	疟
氫	氢
嗆	呛
輭	软
榮	荣
縷	缕
碸	砜
霽	霁
鈿	钿
熾	炽
賀	贺
係	系
諄	谆
黌	黉
軌	轨
絡	络
煩	烦
滬	沪
槮	椮
復	复
聳	耸
蟲	虫
鉿	铪
燾	焘
誅	诛
欄	栏
搆	构
脈	脉
舊	旧
纍	累
箏	筝
頎	颀
澗	涧
褘	袆
岡	冈
嬤	嬷
鐦	锎
刪	删
漬	渍
殯	殡
雜	杂
閻	阎
鎿	镎
瀾	澜
賁	贲
鵡	鹉
槃	盘
巋	岿
猶	犹
彌	弥
顎	颚
釓	钆
癒	愈
動	动
鍔	锷
聞	闻
鵠	鹄
擱	搁
兩	两
貒	猯
亂	乱
樅	枞
牀	床
紋	纹
後	后
飯	饭
鈕	钮
鎔	镕
沖	冲
覘	觇
攛	撺
誚	诮
簡	简
綠	绿
飇	飙
霧	雾
擰	拧
銪	铕
薰	熏
強	强
頹	颓
鍵	键
窺	窥
瞼	睑
傾	倾
蓆	席
懍	懔
壎	埙
鑑	鉴
闐	阗
鉕	钷
櫚	榈
晝	昼
締	缔
廢	废
驥	骥
鯤	鲲
適	适
鋪	铺
濬	浚
譯	译
慳	悭
菴	庵
罷	罢
糶	粜
塹	堑
駸	骎
嫺	娴
陽	阳
澁	涩
蜆	蚬
興	兴
鰌	鳅
喬	乔
銓	铨
癘	疠
兇	凶
記	记
諛	谀
謄	誊
崢	峥
頤	颐
鎩	铩
溫	温
優	优
氬	氩
騸	骟
隻	只
餺	馎
閽	阍
濁	浊
櫃	柜
擇	择
難	难
魎	魉
釕	钌
達	达
詘	诎
藝	艺
摜	掼
髣	仿
絢	绚
塤	埙
靦	腼
軫	轸
豬	猪
嶼	屿
齶	腭
電	电
鑼	锣
鍾	钟
漁	渔
訃	讣
萇	苌
縋	缒
憊	惫
納	纳
鮎	鲇
霑	沾
皐	皋
閒	闲
鄕	乡
蓯	苁
侖	仑
謙	谦
誘	诱
攝	摄
騣	鬃
嶢	峣
夥	伙
鐧	锏
鞦	秋
錩	锠
銨	铵
冪	幂
責	责
殮	殓
誼	谊
斲	斫
鰷	鲦
羶	膻
瘻	瘘
潁	颍
軀	躯
棄	弃
鵂	鸺
塏	垲
闒	阘
陸	陆
譙	谯
虛	虚
齡	龄
廠	厂
鍩	锘
鋨	锇
賬	账
東	东
賒	赊
鱷	鳄
鷄	鸡
現	现
氂	牦
蘆	芦
羋	芈
騎	骑
吒	咤
鄔	邬
攜	携
閧	哄
銩	铥
錨	锚
覯	觏
暱	昵
悵	怅
愴	怆
縶	絷
嬸	婶
璽	玺
鈾	铀
綺	绮
齷	龌
穎	颖
囑	嘱
瑒	玚
僕	仆
識	识
衚	胡
懟	怼
廡	庑
齠	龆
屢	屡
飥	饦
獨	独
濫	滥
賭	赌
赬	赪
詮	诠
學	学
韻	韵
燿	耀
況	况
蠅	蝇
舉	举
麫	面
簍	篓
瀕	濒
贗	赝
準	准
標	标
殘	残
徠	徕
嚦	呖
玨	珏
檮	梼
撲	扑
酈	郦
確	确
緋	绯
賂	赂
曆	历
齋	斋
屍	尸
罌	罂
違	违
釔	钇
慟	恸
繡	绣
糢	模
顥	颢
偽	伪
襯	衬
諮	谘
擲	掷
聵	聩
俁	俣
壺	壶
鑽	钻
協	协
鶉	鹑
鰈	鲽
蠐	蛴
貓	猫
欒	栾
鄖	郧
閙	闹
鐘	钟
稜	棱
巖	岩
鴞	鸮
撣	掸
輪	轮
厭	厌
靜	静
禱	祷
頰	颊
徵	征
縴	纤
証	证
燁	烨
竇	窦
鱈	鳕
齊	齐
蕎	荞
賓	宾
濕	湿
勗	勖
皸	皲
痙	痉
飛	飞
靚	靓
鯝	鲴
廟	庙
鵞	鹅
擣	捣
諧	谐
淩	凌
鋸	锯
鉬	钼
颼	飕
駱	骆
顰	颦
鳳	凤
劍	剑
慶	庆
藹	蔼
詼	诙
滿	满
鐃	铙
鎂	镁
隄	堤
紉	纫
讒	谗
輕	轻
醖	酝
縟	缛
綞	缍
莢	荚
榦	干
洩	泄
貨	货
倫	伦
匭	匦
銬	铐
嘯	啸
單	单
礱	砻
鰳	鳓
癲	癫
張	张
麴	曲
憶	忆
蠻	蛮
欽	钦
剋	克
鷊	鹝
牋	笺
捍	扞
藎	荩
畢	毕
軔	轫
鉗	钳
顛	颠
矚	瞩
幟	帜
緞	缎
摣	揸
噯	嗳
罵	骂
黴	霉
艷	艳
懶	懒
譽	誉
邁	迈
儀	仪
閃	闪
箇	个
順	顺
紈	纨
縊	缢
躂	跶
躕	蹰
輔	辅
倖	幸
稅	税
簞	箪
熱	热
販	贩
醫	医
鐮	镰
颱	台
瀉	泻
綳	绷
麵	面
鼴	鼹
氾	泛
靄	霭
鯇	鲩
顆	颗
鶹	鹠
詒	诒
潔	洁
鏗	铿
駛	驶
竝	并
惡	恶
鋭	锐
鍬	锹
矯	矫
鹹	咸
聶	聂
數	数
鰉	鳇
纊	纩
蠑	蝾
贓	赃
誒	诶
摯	挚
傖	伧
鐙	镫
閘	闸
餛	馄
皚	皑
鮜	鲘
膠	胶
蔣	蒋
趨	趋
躪	躏
爭	争
鎬	镐
報	报
禰	祢
紳	绅
縵	缦
悶	闷
褻	亵
殼	壳
漿	浆
鳴	鸣
釀	酿
鋂	镅
飆	飙
鱉	鳖
態	态
穌	稣
諒	谅
蹕	跸
廏	厩
寜	宁
齟	龃
糞	粪
臠	脔
淨	净
璦	瑷
鉭	钽
壼	壸
顱	颅
駰	骃
絳	绛
鹵	卤
蛺	蛱
潿	涠
賾	赜
鈀	钯
儂	侬
鬆	松
縈	萦
訐	讦
趕	赶
颮	飑
妝	妆
頜	颌
採	采
銫	铯
騰	腾
綵	彩
檻	槛
覽	览
貿	贸
輾	辗
縞	缟
鉀	钾
盃	杯
鑄	铸
壇	坛
筆	笔
拋	抛
臍	脐
詐	诈
豔	艳
韙	韪
陘	陉
駝	驼
硜	硁
藥	药
棧	栈
燭	烛
廳	厅
櫻	樱
敺	驱
錁	锞
銀	银
頇	顸
鼉	鼍
纈	缬
鎖	锁
娛	娱
喚	唤
墜	坠
鰟	鳑
從	从
蔥	葱
輩	辈
鄭	郑
琯	管
鬱	郁
窰	窑
帳	帐
紵	纻
註	注
薺	荠
谿	溪
獁	犸
狀	状
廈	厦
緊	紧
慍	愠
蟎	螨
鷹	鹰
賔	宾
囘	回
驛	驿
嗚	呜
鱟	鲎
淪	沦
瑯	琅
繳	缴
糴	籴
職	职
書	书
藺	蔺
濾	滤
唄	呗
鼈	鳖
誑	诳
謐	谧
贔	赑
熗	炝
嚙	啮
團	团
餜	馃
鸞	鸾
撥	拨
攤	摊
覧	览
陝	陕
傭	佣
嘮	唠
嬰	婴
砲	炮
粵	粤
鴴	鸻
戶	户
殻	壳
渾	浑
勁	劲
區	区
韃	鞑
彈	弹
媯	妫
歐	欧
賕	赇
釗	钊
雙	双
鯛	鲷
篤	笃
鐺	铛
試	试
煬	炀
癮	瘾
灩	滟
塲	场
綿	绵
懷	怀
艶	艳
蝸	蜗
摺	折
製	制
乾	干
鈁	钫
鋁	铝
媮	偷
鍀	锝
縉	缙
羈	羁
攏	拢
樑	梁
讐	仇
輓	挽
犖	荦
堝	埚
鴟	鸱
誦	诵
錫	锡
貪	贪
腳	脚
甯	宁
嚮	向
稱	称
弳	弪
雲	云
鰵	鳘
綴	缀
愷	恺
罈	坛
僂	偻
彷	仿
島	岛
簣	篑
兗	兖
魛	鱽
瓚	瓒
點	点
扡	扦
櫺	棂
諦	谛
獫	猃
質	质
釬	焊
鯰	鲶
飲	饮
練	练
擺	摆
戇	戆
軾	轼
鈄	钭
纇	颣
紆	纡
須	须
輒	辄
讕	谰
瀘	泸
錚	铮
篛	箬
餞	饯
璫	珰
瞭	了
阬	坑
綱	纲
墳	坟
費	费
繞	绕
調	调
嚴	严
靂	雳
剄	刭
絆	绊
擋	挡
腎	肾
豐	丰
詔	诏
燙	烫
灘	滩
鍚	钖
饞	馋
艤	舣
癬	癣
鋯	锆
緱	缑
齲	龋
寵	宠
劄	札
綆	绠
餉	饷
鮊	鲌
檔	档
嘗	尝
傘	伞
鎚	锤
纜	缆
稟	禀
螢	萤
鐫	镌
紱	绂
脹	胀
溼	湿
灃	沣
獅	狮
饉	馑
飈	飙
鯊	鲨
誣	诬
術	术
闖	闯
煙	烟
樺	桦
籛	篯
驟	骤
擠	挤
撓	挠
湧	涌
壽	寿
靭	韧
囬	回
統	统
糰	团
顳	颞
髴	佛
藶	苈
幾	几
軼	轶
詿	诖
醃	腌
銅	铜
錄	录
玀	猡
覓	觅
誕	诞
謔	谑
備	备
鄘	墉
蘢	茏
喫	吃
訪	访
細	细
馳	驰
縲	缧
窵	窎
搶	抢
療	疗
鋅	锌
獄	狱
屆	届
饈	馐
驊	骅
賑	赈
槓	杠
鯢	鲵
鉚	铆
廝	厮
彜	彝
類	类
擡	抬
懣	懑
楨	桢
釦	扣
絰	绖
嫵	妩
魴	鲂
摶	抟
腸	肠
毿	毵
門	门
隂	阴
鎄	锿
鼇	鳌
銖	铢
躒	跞
訕	讪
這	这
鴛	鸳
銚	铫
縝	缜
龜	龟
脣	唇
暢	畅
說	说
匯	汇
鰱	鲢
綰	绾
囂	嚣
鉅	巨
秈	籼
竊	窃
籌	筹
楓	枫
軒	轩
評	评
遙	遥
釘	钉
絛	绦
譎	谲
壞	坏
慣	惯
濺	溅
賦	赋
槨	椁
畫	画
櫪	枥
癭	瘿
巰	巯
聹	聍
懸	悬
濼	泺
歿	殁
劃	划
熅	煴
稈	秆
養	养
醬	酱
踐	践
訂	订
蠔	蚝
圖	图
厙	厍
鰜	鳒
攢	攒
貧	贫
輦	辇
倆	俩
閭	闾
傯	偬
錮	锢
紲	绁
場	场
鶴	鹤
韁	缰
築	筑
饊	馓
藍	蓝
櫓	橹
牘	牍
緝	缉
籜	箨
壟	垄
硤	硖
蕢	蒉
臥	卧
蓧	莜
賧	赕
襪	袜
獮	狝
鵲	鹊
顴	颧
擷	撷
揹	背
嚕	噜
滻	浐
嚀	咛
鈃	钘
閂	闩
還	还
將	将
羆	罴
蘋	苹
屬	属
訓	训
梔	栀
猙	狰
銘	铭
縛	缚
紝	纴
鮞	鲕
辦	办
誨	诲
親	亲
鎮	镇
網	网
餵	喂
貼	贴
囀	啭
煅	锻
竈	灶
敍	叙
懌	怿
潑	泼
淒	凄
絝	绔
曠	旷
櫨	栌
珮	佩
鷲	鹫
飴	饴
葷	荤
蟶	蛏
臺	台
購	购
桿	杆
億	亿
嶇	岖
嬈	娆
頊	顼
躑	踯
讓	让
嘖	啧
錘	锤
紜	纭
鄺	邝
渦	涡
謨	谟
醯	酰
鈮	铌
鰲	鳌
斷	断
貽	贻
榿	桤
參	参
呂	吕
僅	仅
緇	缁
繆	缪
崍	崃
塊	块
臏	膑
軑	轪
務	务
鍘	铡
鵜	鹈
駟	驷
曡	叠
慤	悫
畬	畲
剮	剐
罰	罚
篳	筚
籲	吁
儕	侪
賽	赛
鞀	鼗
钂	镋
瀅	滢
鴇	鸨
墊	垫
損	损
薌	芗
燬	毁
沒	没
覔	觅
隖	坞
鎘	镉
傚	效
綜	综
堦	阶
憤	愤
閬	阆
縱	纵
馴	驯
攷	考
輻	辐
涼	凉
鷴	鹇
噁	恶
獃	呆
燄	焰
訣	诀
綢	绸
衕	同
觔	斤
雖	虽
鏘	锵
豎	竖
鱝	鲼
緜	绵
恥	耻
詩	诗
鑭	镧
鋮	铖
糲	粝
塵	尘
蕷	蓣
菸	烟
滾	滚
跼	局
諾	诺
羅	罗
劇	剧
鄆	郓
閉	闭
訌	讧
憑	凭
蒓	莼
宮	宫
覡	觋
皰	疱
薩	萨
鴆	鸩
鮭	鲑
麯	曲
紮	扎
醱	酦
瀰	弥
録	录
駁	驳
謊	谎
簷	檐
鋇	钡
煆	锻
驢	驴
嫗	妪
鷙	鸷
鱘	鲟
鏝	镘
啞	哑
賣	卖
蹤	踪
苧	苎
腦	脑
飫	饫
婬	淫
凱	凯
獲	获
噴	喷
諷	讽
惻	恻
鰃	鳂
誌	志
紙	纸
銜	衔
僱	雇
氣	气
輥	辊
戧	戗
頫	俯
鬭	斗
吳	吴
厲	厉
隴	陇
貸	贷
蘿	萝
籃	篮
廄	厩
則	则
蝕	蚀
顏	颜
驗	验
癟	瘪
闞	阚
蕩	荡
顫	颤
繯	缳
獼	猕
觶	觯
浹	浃
賸	剩
迺	乃
夀	寿
綃	绡
騂	骍
麅	狍
瀆	渎
璉	琏
見	见
認	认
紘	纮
鸚	鹦
訢	欣
躥	蹿
莧	苋
颳	刮
鰮	鳁
鄰	邻
爲	为
蠶	蚕
螿	螀
搾	榨
驂	骖
鏇	旋
構	构
諍	诤
譌	讹
汎	泛
鯗	鲞
繚	缭
勝	胜
鑞	镴
裡	里
襠	裆
橢	椭
轤	轳
籮	箩
烱	炯
蹺	跷
幫	帮
頁	页
錇	锫
閈	闬
隊	队
讌	燕
耑	端
憐	怜
顯	显
鶘	鹕
脛	胫
鉄	铁
檢	检
澤	泽
潤	润
礫	砾
稭	秸
週	周
銲	焊
蓋	盖
撾	挝
絃	弦
繅	缫
鍇	锴
瑉	珉
闈	闱
處	处
諸	诸
籙	箓
緘	缄
廚	厨
剝	剥
鏜	镗
辤	辞
諢	诨
濤	涛
對	对
婭	娅
寬	宽
護	护
棶	梾
擾	扰
鮁	鲅
邇	迩
騭	骘
釙	钋
鰂	鲗
斕	斓
銛	铦
級	级
餄	饸
攪	搅
馭	驭
糧	粮
鈰	铈
嚳	喾
儲	储
芻	刍
膽	胆
撿	捡
鯁	鲠
驀	蓦
黃	黄
鍆	钔
請	请
槍	枪
簾	帘
轎	轿
鰹	鲣
嶸	嵘
幘	帻
勛	勋
針	针
遜	逊
睞	睐
詠	咏
淥	渌
蕪	芜
駭	骇
顬	颥
鐒	铹
紇	纥
懽	欢
聼	听
儔	俦
紅	红
玆	兹
疊	迭
憒	愦
蒔	莳
頗	颇
纘	缵
爛	烂
鶚	鹗
瞞	瞒
謡	谣
誠	诚
騫	骞
匱	匮
熲	颎
繃	绷
積	积
橋	桥
闊	阔
襍	杂
蕕	莸
擔	担
塗	涂
選	选
彙	汇
鉛	铅
線	线
韞	韫
歡	欢
蹣	蹒
獺	獭
賤	贱
釐	厘
穫	获
藪	薮
繼	继
鋰	锂
陳	陈
軸	轴
淺	浅
嬀	妫
頂	顶
約	约
蝦	虾
褌	裈
攔	拦
鎛	镈
騮	骝
瘞	瘗
誡	诫
謠	谣
鮫	鲛
碭	砀
礬	矾
綯	绹
縮	缩
瀲	潋
璵	玙
覷	觑
訶	诃
漸	渐
悽	凄
組	组
牆	墙
囉	啰
靈	灵
帶	带
擕	携
陞	升
諡	谥
艦	舰
蝨	虱
寫	写
飭	饬
奬	奖
緯	纬
繮	缰
鋱	铽
獰	狞
遲	迟
軹	轵
項	项
爾	尔
騁	骋
盪	荡
嶄	崭
蠍	蝎
贏	赢
鱂	鳉
專	专
薔	蔷
錛	锛
瀝	沥
醜	丑
嶠	娇
漣	涟
磽	硗
頭	头
馬	马
鴯	鸸
鎰	镒
鐵	铁
貺	贶
紛	纷
婁	娄
節	节
鱅	鳙
緄	绲
煇	辉
癉	瘅
瓊	琼
連	连
滎	荥
饗	飨
髖	髋
繙	翻
鍛	锻
灝	灏
凜	凛
啟	启
雞	鸡
詡	诩
孫	孙
鵯	鹎
鑒	鉴
呵	嗬
閲	阅
諶	谌
賺	赚
聽	听
懼	惧
綁	绑
簀	箦
鼂	鼌
營	营
鷗	鸥
嚇	吓
倈	俫
薑	姜
戔	戋
麗	丽
領	领
鬚	须
嘜	唛
漢	汉
蔦	茑
膩	腻
骯	肮
礮	炮
閱	阅
傳	传
鎵	镓
臟	脏
讞	谳
洶	汹
撻	挞
愾	忾
鷁	鹢
驄	骢
彠	彟
燉	炖
鍊	炼
蹌	跄
諏	诹
駙	驸
願	愿
魚	鱼
韝	鞴
陜	陕
鋟	锓
跡	迹
轢	轹
鈐	钤
幬	帱
奮	奋
鑰	钥
鏵	铧
剴	剀
滷	卤
擻	擞
慾	欲
頃	顷
閆	闫
鄉	乡
鎊	镑
蒐	搜
鶖	鹙
礙	碍
犛	牦
醞	酝
負	负
蠣	蛎
誤	误
薦	荐
脩	修
簫	箫
馮	冯
環	环
鑲	镶
殺	杀
膾	脍
硃	朱
竄	窜
癇	痫
闆	板
煉	炼
轍	辙
滌	涤
尷	尴
幗	帼
鷖	鹥
壘	垒
盜	盗
賠	赔
諤	谔
虧	亏
廬	庐
駮	驳
畱	留
獵	猎
淶	涞
摻	掺
飢	饥
紀	纪
縂	总
瞇	眯
澀	涩
儈	侩
躍	跃
餘	余
財	财
渢	沨
誥	诰
愨	悫
綫	线
鄲	郸
侷	局
褸	褛
診	诊
絀	绌
竅	窍
矇	蒙
僉	佥
鰍	鳅
軍	军
鱖	鳜
壙	圹
驚	惊
睜	睁
鏟	铲
遞	递
賡	赓
櫥	橱
葦	苇
鷦	鹪
齬	龉
異	异
噲	哙
勵	励
逕	径
聾	聋
餃	饺
騅	骓
崗	岗
圇	囵
穀	谷
倉	仓
夾	夹
贋	赝
劊	刽
欏	椤
禦	御
錟	锬
訥	讷
殤	殇
朧	胧
縭	缡
徬	仿
墮	堕
琱	雕
貶	贬
鷀	鹚
饃	馍
廂	厢
驅	驱
範	范
偉	伟
燈	灯
譏	讥
摑	掴
齗	龂
顙	颡
駘	骀
彎	弯
噝	咝
韜	韬
僞	伪
臨	临
繭	茧
翬	翚
魯	鲁
呱	哌
兒	儿
創	创
衹	只
觸	触
諺	谚
紂	纣
謖	谡
鈈	钚
躋	跻
謎	谜
際	际
餚	肴
檣	樯
覥	觍
庫	库
維	维
颯	飒
鬮	阄
嘰	叽
銳	锐
買	买
樸	朴
開	开
挾	挟
幀	帧
終	终
鉈	铊
軋	轧
裏	里
歎	叹
蕒	荬
雛	雏
灕	漓
郟	郏
層	层
蹠	跖
颺	扬
擧	举
紐	纽
籬	篱
磯	矶
閼	阏
癰	痈
勳	勋
釵	钗
側	侧
蛻	蜕
櫫	橥
餅	饼
冊	册
贍	赡
讎	仇
儘	尽
嬙	嫱
崙	仑
閫	阃
瀟	潇
籟	籁
樣	样
鏢	镖
縫	缝
堯	尧
鮮	鲜
禮	礼
鈳	钶
喲	哟
傴	伛
侶	侣
謹	谨
檸	柠
覺	觉
蒼	苍
驃	骠
鷂	鹞
饅	馒
飄	飘
韆	千
鱗	鳞
畝	亩
鋻	鉴
鏞	镛
轡	辔
詣	诣
撐	撑
繫	系
鳬	凫
硯	砚
烴	烃
濶	阔
櫸	榉
擼	撸
鮃	鲆
師	师
礄	硚
疇	畴
嘆	叹
劉	刘
貍	狸
規	规
討	讨
嶗	崂
緙	缂
鈞	钧
躡	蹑
鴰	鸹
種	种
隱	隐
鎳	镍
鐲	镯
債	债
鄴	邺
誹	诽
螻	蝼
膿	脓
廁	厕
鶯	莺
嗇	啬
癆	痨
遊	游
詎	讵
葒	荭
緗	缃
繖	伞
魘	魇
塚	冢
鶻	鹘
凟	渎
鉞	钺
鈺	钰
襤	褴
捨	舍
鵬	鹏
坰	垧
瑲	玱
郵	邮
歸	归
蟻	蚁
蓽	荜
堅	坚
鈉	钠
鱭	鲚
紿	绐
邊	边
椏	丫
紗	纱
纖	纤
騙	骗
償	偿
澠	渑
貢	贡
戩	戬
鰭	鳍
綬	绶
窮	穷
錳	锰
樹	树
煖	暖
於	于
孃	娘
鉉	铉
鏈	链
嵗	岁
磚	砖
關	关
勞	劳
俠	侠
陰	阴
槤	梿
嵐	岚
彫	雕
屭	屃
緬	缅
髮	发
癱	瘫
埰	采
偵	侦
燴	烩
隨	随
叄	叁
